12 10
. . . . . . . . . I I .
~ ~ X . . F F F X . I .
. ~ X ~ . . . . . . I .
. . X . . . . ~ X ~ . .
. m m m . . . . . . . .
. . . . X X m ~ X ~ . .
~ ~ X . . . . . . . I .
. ~ X ~ . . . . X . . .
. . X m m m . X X ~ . .
. m m m . . . . . F F .
